1111111111
1000050001
1000000001
1010100001
1001000001
1005105001
1070000011
1005000001
1000000001
1111111111