1111111111
1000070101
1000000001
1005000001
1000000001
1006000001
1000000001
1605700001
1000000601
1111111111