1111111111
1000000001
1000100501
1000000011
1070000001
1000610001
1110550001
1000007001
1000016001
1111111111