1111111111
1000000061
1000106001
1000000001
1000000701
1760000001
1067000501
1000000001
1000000661
1111111111