1111111111
1050005001
1000500151
1050010001
1000000001
1000000001
1000000071
1010100051
1000000001
1111111111