1111111111
1005005011
1000100001
1006000171
1060070011
1000705101
1000000611
1000000001
1000070001
1111111111