1111111111
1700005001
1000000001
1610001101
1700070001
1075070001
1000006001
1000100071
1000500001
1111111111