1111111111
1005600001
1000000001
1100600001
1550000601
1516000001
1050000001
1001005011
1066005001
1111111111