1111111111
1000000061
1000000001
1000006001
1000000001
1007010001
1000000001
1000516071
1000055001
1111111111